11111111111111
10100100000001
10110100000001
100000C1101111
10100001000001
101000010001E1
11111111111111