11111111111111
1P1C0100000001
1011I100000001
100000C1101111
10100001000001
10100001000101
11111111111111