11111111111111
1P1C0100000001
10110100000001
100000C1101111
10100001000011
101000010001E1
11111111111111