1111111111111111
1C00010C1P0C0001
11110101110000E1
1000000000C11111
1000100C01000001
111C100001000101
1000001111000111
1001111000000101
10C0001000100001
1111111111111111