11111111111111
1P100100000001
10110100000001
1000C00110111
10100001000001
101000010001E1
11111111111111