11111111111111
1P1C01000C0001
10110100000001
10000001101111
10100C01000001
1C10000100C1E1
11111111111111