1111111111111111
1C00010C1P0C0001
1111010111000001
1000000000011111
1000100C01000001
111C10000100C1E1
1000001111000111
10011110000001C1
10000C100C100001
1111111111111111