11111111111111
1P100100000001
10110100000001
100000C1101111
1010001000001
1E1000010001E1
11111111111111