111111111111111111111111111111111111111111111111111
1000010C1P000000000000000000000000000000000000C0001
111101011100000000000000000000000000010000000000001
1000000000C0011110000001111111111000011111111111111
1000100111000001000000C0000000000000000000000000001
11101000C100000000111000000000C00011111000011100001
100000111100011100000000000000000000E0000001C000001
10011010000001C100001111000000000000000000011100001
100000100000000000C01000000000000000000000000000001
1C0000100000011100001000000000000011C0000000C100001
1000111000000001000011110000C0000001110000011100001
100000100010000100001C00000000000000000000000000001
100000C01110000100001000000000000000C00000000000001
100111100000000100001111111110000000000000010100001
100000100000000100000C00000010000000000000010100001
100000111100011111001001000010000000C000000100C0001
1001111000000001C00011110000000C0000000000011100001
10000C100010000100001C00000000000000000000000000001
111111111111111111111111111111111111111111111111111