11111111111111
1P100100000001
1011010000P001
100000C1101111
10100001000001
101000010001E1
11111111111111