11111111111111
1P100100000001
10110100000001
100000C1101111
10100001000001
10100001000101
11111111111111